########
#S..r..#
#......#
###D####
#......#
#....G.#
########
