########
#S.....#
#......#
#......#
#....G.#
########
